1111111111111111111111111111111111111
1000000001C00000001000000000000000001
10P0000001111111101011111111111000001
10000000000000000010100000000C1000001
10000000000000000010000000000C1000001
1000000000000000001111111111111000001
1000000000000000000000000000000000001
10000000000C000000K000000000000000001
1000000000000000000000000000000000001
1000000000000000000000000000000000001
1000011111111111111000000000000000001
1000010000000000001000000000000000001
1000010000000000001000000000000011011
10000000000C0000001000000000000010001
1000010000000000001000000000000000E01
1000010000000000001C00000000000010001
1111111111111111111111111111111111111